Abbey 	Fencing Salon 	Parochial School
Aboriginal and Torres Strait Islander Organisation 	Fencing School 	Parsi Temple
Aboriginal Art Gallery 	Feng Shui Consultant 	Part Time Daycare
Abortion Clinic 	Feng Shui Shop 	Party Equipment Rental Service
Abrasives Supplier 	Ferris wheel 	Party Planner
Abundant Life Church 	Ferry Service 	Party Store
Accountant 	Fertility Clinic 	Passport Agent
Accounting Firm 	Fertility Physician 	Passport Office
Accounting School 	Fertilizer Supplier 	Passport Photo Processor
Accounting Software Company 	Festival 	Pasta Shop
Acoustical Consultant 	Festival Hall 	Pastry Shop
Acrobatic Diving Pool 	Fiat dealer 	Patent Attorney
Acrylic Store 	Fiber Optic Products Supplier 	Patent Office
Acupuncture Clinic 	Fiberglass Repair Service 	Paternity Testing Service
Acupuncture School 	Fiberglass Supplier 	Pathologist
Acupuncturist 	Figurine Shop 	Patients Support Association
Acura Dealer 	Filipino Restaurant 	Patio Enclosure Supplier
Addiction Treatment Center 	Film and Photograph Library 	Patisserie
Administrative Attorney 	Film Production Company 	Paving Contractor
Adoption Agency 	Filtration Plant 	Paving Materials Supplier
Adult Day Care Center 	Finance Broker 	Pawn Shop
Adult DVD Store 	Financial Audit 	Payphone
Adult Education School 	Financial Consultant 	Payroll Service
Adult Entertainment Club 	Financial Institution 	Public Call Office Booth
Adult Entertainment Store 	Financial Planner 	Pedestrian Zone
Adult Foster Care Service 	Fine Dining Restaurant 	Pediatric Cardiologist
Adventure Sports 	Fingerprinting Service 	Pediatric Dentist
Adventure Sports Center 	Finishing Materials Supplier 	Pediatric Ophthalmologist
Advertising Agency 	Finnish Restaurant 	Pediatrician
Commercial Photographer 	Fire Alarm Supplier 	Pen Store
Advertising Service 	Fire Damage Restoration Service 	Pennsylvania Dutch Restaurant
Aerated Drinks Supplier 	Fire Department Equipment Supplier 	Pension Office
Antenna Service 	Fire Fighters Academy 	Pentecostal Church
Aerial Photographer 	Fire Protection Consultant 	People S House
Aerial Sports Center 	Fire Protection Equipment Supplier 	Performing Arts Group
Aero Dance Class 	Fire Protection Service 	Performing Arts Theater
Aerobics Instructor 	Fire Protection System Supplier 	Perfume Store
Aeroclub 	Fire Station 	Perinatal Center
Aeromodel Shop 	Firearms Academy 	Periodontist
Aeronautical Engineer 	Fireplace Manufacturer 	Permanent Make-up Clinic
Aerospace Company 	Fireplace Store 	Persian Restaurant
Afghani Restaurant 	Firewood Supplier 	Personal Injury Attorney
African Goods Store 	Fireworks Store 	Personal Trainer
African Restaurant 	Fireworks Supplier 	Peruvian Restaurant
After School Program 	First Aid Station 	Pest Control Service
Agenzia Entrate 	Fish & Chips Restaurant 	Pet Adoption Service
Aggregate Supplier 	Fish and Chips Takeaway 	Pet Boarding Service
Agistment Service 	Fish Farm 	Pet Cemetery
Agricultural Association 	Fish Processing 	Pet Friendly Accommodation
Agricultural Cooperative 	Fish Spa 	Pet Funeral Service
Agricultural Engineer 	Fish Store 	Pet Groomer
Agricultural High School 	Fishing Camp 	Pet Moving Service
Agricultural Machinery Manufacturer 	Fishing Charter 	Pet Sitter
Agricultural Organization 	Fishing Club 	Pet Store
Agricultural Product Wholesaler 	Fishing Pier 	Pet Supply Store
Agricultural Production 	Fishing Pond 	Pet Trainer
Agricultural Service 	Fishing Store 	Petrochemical Engineer
Agricultural Service Supply Agency 	Health Club 	Petroleum Products Company
Agriculture Cooperative 	Exercise Equipment Store 	Pharmaceutical Company
Agrochemicals Supplier 	Fitness Equipment Wholesaler 	Pharmaceutical Lab
Aikido Club 	Fitted Furniture Supplier 	Pharmaceutical Products Wholesaler
Aikido School 	Flag Store 	Pharmacy
Air Compressor Repair Service 	Flamenco Dance Store 	Philharmonic Hall
Air Compressor Supplier 	Flamenco School 	Pho Restaurant
Air Conditioning Contractor 	Flamenco Theater 	Phone Repair Service
Air Conditioning Repair Service 	Flavours Fragrances and Aroma Supplier 	Photo Agency
Air Conditioning Store 	Flea Market 	Photo Lab
Air Conditioning System Supplier 	Flight School 	Photo Restoration Service
Air Duct Cleaning Service 	Floating Market 	Photo Shop
Air Filter Supplier 	Floor Refinishing Service 	Photocopiers Supplier
Air Force Base 	Floor Sanding and Polishing Service 	Photographer
Air Taxi 	Flooring Contractor 	Photography Class
Airbrushing Service 	Flooring Store 	Photography School
Airbrushing Supply Store 	Floridian Restaurant 	Photography Service
Aircraft Maintenance Company 	Florist 	Photography Studio
Aircraft Manufacturer 	Flour Mill 	Physiatrist
Aircraft Rental Service 	Flower Delivery 	Physical Examination Center
Aircraft Supply Store 	Flower Designer 	Physical Fitness Program
Airline 	Flower Market 	Physician Referral Service
Airline Ticket Agency 	FMCG Goods Wholesaler 	Physical Therapist
Airplane 	FMCG Manufacturer 	Physical Therapy Clinic
Airport 	Foam Rubber Producer 	Physiotherapy Equip Supplier
Airport Hotel 	Foam Rubber Supplier 	Piano Bar
Airport Shuttle Service 	Folk High School 	Piano Instructor
Airsoft Supply Store 	Fondue Restaurant 	Piano Maker
Airstrip 	Food and Beverage Consultant 	Piano Moving Service
Alcohol Manufacturer 	Food and Beverage Exporter 	Piano Repair Service
Alcohol Retail Monopoly 	Food Bank 	Piano Store
Alcoholic Beverage Wholesaler 	Food Broker 	Piano Tuning Service
Alcoholism Treatment Program 	Food Court 	Pick Your Own Farm Produce
Allergist 	Food Machinery Supplier 	Picnic Ground
Alliance Church 	Food Manufacturer 	Picture Frame Renovating and Restoring Service
Alsace Restaurant 	Food Manufacturing Supply 	Picture Frame Shop
Alternative Fuel Station 	Food Processing Company 	Pie Shop
Alternative Medicine Practitioner 	Food Processing Equipment 	Pilates Studio
Alternator Supplier 	Food Producer 	Pile Driver
Aluminum Supplier 	Food Products Supplier 	Pilgrimage Place
Aluminum Frames Supplier 	Food Seasoning Manufacturer 	Pinatas Supplier
Aluminum Welder 	Foot Bath 	Pinball Machine Supplier
Aluminum Window 	Foot Care 	Pine Furniture Shop
Amateur theater 	Foot Massage Parlor 	Pipe Supplier
Ambulance Service 	Football Club 	Piste Vtt
American Restaurant 	American Football Field 	Pizza Delivery
Amish Furniture Store 	Ford Dealer 	Pizza Restaurant
Ammunition Supplier 	Foreclosure Service 	Pizza Takeaway
Amphitheater 	Foreign Consulate 	Place of Worship
Amusement Center 	Foreign Exchange Students Organization 	Planetarium
Amusement Machine Supplier 	Foreign Languages Program School 	Plant and Machinery Hire
Amusement Park 	Foreign Trade Consultant 	Plant Nursery
Amusement Park Ride 	Foreman Builders Association 	Plast Window Store
Amusement Ride Supplier 	Forensic Consultant 	Plasterer
An Hui Restaurant 	Forestry Service 	Plastic Bag Supplier
Anago Restaurant 	Forklift Dealer 	Plastic Bags Wholesaler
Andalusian Restaurant 	Forklift Rental Service 	Plastic Fabrication Company
Anesthesiologist 	Formal Wear Store 	Plastic Injection Molding Service
Angler Fish Restaurant 	Fortress 	Plastic Products Supplier
Anglican Church 	Fortune Telling Services 	Plastic Resin Manufacturer
Animal Control Service 	Foster Care Service 	Plastic Surgeon
Animal Hospital 	Foundation 	Plastic Surgery Clinic
Animal Park 	Foundry 	Plastic Wholesaler
Animal Protection Organization 	Fountain Contractor 	Plating Service
Animal Rescue Service 	Foursquare Church 	Play School
Animal Shelter 	Fraternal Organization 	Playground
Animation Studio 	Free Clinic 	Playground Equipment Supplier
Anime Club 	Free Parking Lot 	Playgroup
Anodizer 	Freestyle Wrestling 	Plumber
Antique Furniture Restoration Service 	Freight Forwarding Service 	Plumbing Supply Store
Antique Furniture Store 	French Language School 	Plus Size Clothing Store
Antique Store 	French Restaurant 	Plywood Supplier
Apartment Building 	French Steakhouse Restaurant 	Pneumatic Tools Supplier
Apartment Complex 	Fresh Food Market 	Po’ Boys Restaurant
Apartment Rental Agency 	Fried Chicken Takeaway 	Podiatrist
Apostolic Church 	Friends Church 	Police Academy
Appliance Parts Supplier 	Frituur 	Police Supply Store
Appliance Rental Service 	Frozen Dessert Supplier 	Polish Restaurant
Appliance Repair Service 	Frozen Food Manufacturer 	Political Party
Appliance Store 	Frozen Food Store 	Polo Club
Appliances Customer Service 	Frozen Yogurt Shop 	Polygraph Service
Appraiser 	Fruit and Vegetable Processing 	Polymer Supplier
Apprenticeship Center 	Fruit and Vegetable Store 	Polynesian Restaurant
Aquaculture Farm 	Fruit and Vegetable Wholesaler 	Polytechnic
Aquarium 	Fruit Parlor 	Polythene and Plastic Sheeting Supplier
Aquarium Shop 	Fruit Wholesaler 	Pond Contractor
Aquatic Centre 	Fruits Wholesaler 	Pond Fish Supplier
Arboretum 	Fu Jian Restaurant 	Pond Supply Store
Arborist and Tree Surgeon 	Fuel Supplier 	Pontiac Dealer
Archaeological Museum 	Fugu Restaurant 	Pony Club
Archery Club 	Full Dress Rental Service 	Pony Ride Service
Archery Event 	Full Gospel Church 	Pool Academy
Archery Hall 	Function Room Facility 	Pool Billard Club
Archery Range 	Fund Management Company 	Pool Cleaning Service
Archery Store 	Funeral Director 	Pool Hall
Architect 	Funeral Home 	Popcorn Store
Architects Association 	Fur Coat Shop 	Katsudon Restaurant
Architectural and Engineering Model Maker 	Fur Manufacturer 	Porridge Restaurant
Architectural Designer 	Fur Service 	Porsche Dealer
Architectural Salvage Store 	Furnace Parts Supplier 	Port Authority
Architecture Firm 	Furnace Repair Service 	Port Operating Company
Architecture School 	Furnace Store 	Portable Building Manufacturer
Archive 	Furnished Apartment Building 	Portable Toilet Supplier
Arena 	Furniture Accessories 	Portrait Studio
Argentinian Restaurant 	Furniture Accessories Supplier 	Portuguese Restaurant
Armed Forces Association 	Furniture Maker 	Post Office
Armenian Church 	Furniture Manufacturer 	Poster Store
Armenian Restaurant 	Furniture Rental Service 	Pottery Classes
Army & Navy Surplus Shop 	Furniture Repair Shop 	Pottery Manufacturer
Army Barracks 	Furniture Store 	Pottery Store
Army Facility 	Furniture Wholesaler 	Poultry Farm
Army Museum 	Fusion Restaurant 	Poultry Store
Aromatherapy Class 	Futon Store 	Powder Coating Service
Aromatherapy Service 	Futsal Court 	Power Station
Aromatherapy Supply Store 	Galician Restaurant 	Power Plant Consultant
Art Cafe 	Gambling House 	Power Plant Equipment Supplier
Art Center 	Gambling Instructor 	Prawn Fishing
Art Dealer 	Game Store 	Pre Gymnasium School
Art Gallery 	Garage Builder 	Precision Engineer
Art Handcraft 	Garage Door Supplier 	Prefabricated House Companies
Art Museum 	Garbage Collection Service 	Prefecture
Art Restoration Service 	Garbage Dump 	Japanese Prefecture Government Office
Art School 	Garbage Dump Service 	Pregnancy Care Center
Art Studio 	Garden 	Preparatory School
Art Supply Store 	Garden Building Supplier 	Presbyterian Church
Artificial Plant Supplier 	Garden Center 	Preschool
Artist 	Garden Furniture Shop 	Press Advisory
Artistic Painting School 	Garden Machinery Supplier 	Pressure Washing Service
Arts Organization 	Gardener 	Pretzel Store
Grill 	Garment Exporter 	Priest
Asbestos Testing Service 	Gas Company 	Primary School
Ashram 	Gas Cylinders Supplier 	Print Shop
Asian Fusion Restaurant 	Gas Engineer 	Printed Music Publisher
Asian Grocery Store 	Gas Installation Service 	Printer Ink Refill Store
Asian Household Goods Store 	Gas Logs Supplier 	Printer Repair Service
Asian Massage Therapist 	Gas Shop 	Printing Equipment and Supplies
Asian Restaurant 	Gas Station 	Printing Equipment Supplier
Asphalt Contractor 	Gasfitter 	Prison
Asphalt Mixing Plant 	Gasket Manufacturer 	Private College
Assemblies of God Church 	Gastroenterologist 	Private Equity Firm
Assembly Room 	Gastrointestinal Surgeon 	Private Golf Course
Assistante Maternelle 	Gastropub 	Homestay
Assisted Living Facility 	Gay & Lesbian Organization 	Private Hospital
Association or Organization 	Gay Bar 	Private Investigator
Astrologer 	Gay Night Club 	Private School
Asturian Restaurant 	Gay Sauna 	Private Sector Bank
Athletic Club 	Gazebo Builder 	Private Tutor
Athletic Field 	Gemologist 	Private University
Athletic Park 	Genealogist 	Probation Office
Athletic Track 	General Contractor 	Process Server
ATM 	General Hospital 	Proctologist
Attorney Referral Service 	General Practice Attorney 	Produce Market
ATV Dealer 	General Practitioner 	Produce Wholesaler
ATV Rental Service 	General Register Office 	Producteur de Champagne
ATV Repair Shop 	General Store 	Producteur de Foie Gras
Auction House 	Generator Shop 	Producteur Eau Minerale
Audi Dealer 	Geography and History Faculty 	Professional and Hobby Associations
Audio Visual Consultant 	Geological Research Company 	Professional Organizer
Audio Visual Equipment Rental Service 	Geological Service 	Promenade
Audio Visual Equipment Repair Service 	Geologist 	Promotional Products Supplier
Audio Visual Equipment Supplier 	Georgian Restaurant 	Propane Supplier
Audiologist 	Geotechnical Engineer 	Propeller Shop
Auditor 	German Language School 	Property Administrator
Auditorium 	German Restaurant 	Property Investment
Australian Goods Store 	Ghost Town 	Property Maintenance
Australian Restaurant 	Gift Basket Store 	Property Management Company
Austrian Restaurant 	Gift Shop 	Land Registry Office
Auto Accessories Wholesaler 	Gift Wrap Store 	Prosthetics
Auto Air Conditioning Service 	Girl Bar 	Protective Clothing Supplier
Auto Auction 	Girls’ High School 	Protestant Church
Auto Body Parts Supplier 	Glass & Mirror Shop 	Provence Restaurant
Auto Body Shop 	Glass Block Supplier 	Provincial Council
Auto Broker 	Glass Blower 	Psychiatric Hospital
Auto Chemistry Shop 	Glass Cutting Service 	Psychiatrist
Auto Dent Removal Service 	Glass Engraver 	Psychic
Auto Electrical Service 	Glass Etching Service 	Psychoanalyst
Auto Glass Shop 	Glass Industry 	Psychologist
Auto Insurance Agency 	Glass Manufacturer 	Psychoneurological Specialized Clinic
Auto Machine Shop 	Glass Merchant 	Psychopedagogy Clinic
Auto Market 	Glass Repair Service 	Psychosomatic Medical Practitioner
Auto Parts Manufacturer 	Glass Shop 	Psychotherapist
Auto Parts Market 	Glassware Manufacturer 	Pub
Auto Parts Store 	Glassware Store 	Public Amenity House
Auto Radiator Repair Service 	Glassware Wholesaler 	Public Bath
Auto Repair Shop 	Glazier 	Public Bathroom
Auto Restoration Service 	Gluten-Free Restaurant 	Public Defender’s Office
Auto Spring Shop 	GMC Dealer 	Public Female Bathroom
Auto Sunroof Shop 	Go-Kart Track 	Public Golf Course
Auto Tag Agency 	Gold Dealer 	Public Health Department
Auto Tune Up Service 	Gold Mining Company 	Public Housing
Auto Upholsterer 	Goldfish Store 	Public Library
Auto Wrecker 	Goldsmith 	Public Male Bathroom
Automation Company 	Golf Cart Dealer 	Public Medical Center
Automobile Storage Facility 	Golf Club 	Public Parking Space
Aviation Consultant 	Golf Course 	Public Prosecutors Office
Aviation Training Institute 	Golf Course Builder 	Public Relations Firm
Awning Supplier 	Golf Driving Range 	Public Safety Office
Baby Clothing Store 	Golf Instructor 	Public Sauna
Baby Store 	Golf Resort 	Public School
Baby Swimming School 	Gospel Church 	Public Sector Bank
Childminder 	Gourmet Grocery Store 	Public Swimming Pool
Badminton Club 	Government College 	Public University
Badminton Complex 	Government Economic Program 	Public Webcam
Badminton Court 	Government Hospital 	Public Wheelchair-Accessible Bathroom
Bag Shop 	Government Office 	Public Works Department
Bagel Shop 	Government School 	Publisher
Bahá’í House of Worship 	GPS Supplier 	Puerto Rican Restaurant
Bail Bonds Service 	Graduate School 	Pulmonologist
Bailiff 	Graffiti Removal Service 	Pump Supplier
Bait Shop 	Grain Elevator 	Pumping Equipment and Service
Bakery 	Grammar School 	Pumpkin Patch
Bakery Equipment 	Grand Cafe 	Punjabi Restaurant
Baking Supply Store 	Grande Ecole 	Puppet Theater
Ballet School 	Granite Supplier 	PVC Industry
Ballet Theater 	Graphic Designer 	PVC Windows Supplier
Balloon Artist 	Gravel Pit 	Qing Fang Market Place
Balloon Ride Tour Agency 	Gravel Plant 	Quad Rental Service
Balloon Store 	Greco Roman Wrestling 	Quaker Church
Ballroom 	Greek Orthodox Church 	Quantity Surveyor
Ballroom Dance Instructor 	Greek Restaurant 	Quarry
Band 	Green Energy Supplier 	Québécois Restaurant
Bangladeshi Restaurant 	Greengrocer 	Quilt Shop
Bank 	Greenhouse 	Race Car Dealer
Bankruptcy Attorney 	Greeting Card Shop 	Racecourse
Bankruptcy Service 	Greyhound Stadium 	Racing Car Parts Store
Banner Store 	Grill Store 	Raclette Restaurant
Banquet Hall 	Grocery Delivery Service 	Racquetball Club
Baptist Church 	Grocery Store 	Radiator Repair Service
Bar 	Ground Self Defense Force 	Radiator Shop
Bar & Grill 	Group Accommodation 	Radio Broadcaster
Bar PMU 	Group Home 	Radiologist
Bar Restaurant Furniture Store 	Guardia Civil 	Raft Trip Outfitter
Bar Stool Supplier 	Guardia Di Finanza Police 	Rafting
Bar Tabac 	Guatemalan Restaurant 	Rail Museum
Barbecue Restaurant 	Guest House 	Railing Contractor
Barbecue area 	Gui Zhou Restaurant 	Railroad Company
Barber School 	Guitar Instructor 	Railroad Contractor
Barber Shop 	Guitar Store 	Railroad Equipment Supplier
Barber Supply Store 	Gun Club 	Railroad Ties Supplier
Bark Supplier 	Gun Shop 	Railway Services
Barrel Supplier 	Offal Barbecue Restaurant 	Rainwater Tank Supplier
Barrister 	Gutter Cleaning Service 	Ramen Restaurant
Bartending School 	Gym 	Ranch
Baseball 	Gymnasium Cz 	Rare Book Store
Baseball Club 	Gymnasium School 	Raw Food Restaurant
Baseball Field 	Gymnastics Center 	Ready Mix Concrete Supplier
Baseball Goods Store 	Gymnastics Club 	Real Estate Agency
Basilica 	Obstetrician-Gynecologist 	Real Estate Agents
Basket Supplier 	Gypsum Product Supplier 	Real Estate Appraiser
Basketball Club 	Gyro Restaurant 	Real Estate Attorney
Basketball Court 	Haberdashery 	Real Estate Auctioneer
Basketball Court Contractor 	Hair Extension Technician 	Real Estate Consultant
Basque Restaurant 	Hair Extensions Supplier 	Real Estate Developer
Bathroom Remodeler 	Hair Removal Service 	Real Estate Fair
Bathroom Supply Store 	Hair Replacement Service 	Real Estate Rental Agency
Battery Manufacturer 	Hair Salon 	Real Estate School
Battery Store 	Hair Transplantation Clinic 	Real Estate Surveyor
Battery Wholesaler 	Haitian Restaurant 	Reclamation Centre
Batting Cage Center 	Hakka Restaurant 	Record Company
Bazar 	Halal Restaurant 	Records Storage Facility
BBQ Area 	Halfway House 	Record Store
Beach Cleaning Service 	Ham Shop 	Recording Studio
Beach Clothing Store 	Hamburger Restaurant 	Recreation Center
Beach Entertainment Shop 	Hammam 	Recruiter
Beach Pavillion 	Hand Surgeon 	Rectory
Beach Resort 	Handbags Shop 	Recycling Center
Beach Volleyball Club 	Handball Club 	Reenactment Site
Beach Volleyball Court 	Handball Court 	Reflexologist
Bead Store 	Handicapped Transportation Service 	Reform Synagogue
Bead Wholesaler 	Handicraft 	Reformed Church
Bearing Supplier 	Handicraft Exporter 	Refrigerated Transport Service
Beauty Product Supplier 	Handicraft Fair 	Refrigerator Repair Service
Beauty Products Vending Machine 	Handicraft Museum 	Refrigerator Store
Beauty Products Wholesaler 	Handicraft School 	Refugee Camp
Beauty Salon 	Handicrafts Wholesaler 	Regional Airport
Beauty School 	Handyman 	Regional Council
Beauty Supply Store 	Hang Gliding Center 	Regional Government Office
Bed & Breakfast 	Hardware Store 	Registered General Nurse
Bed Shop 	Hardware Training Institute 	Registration Chamber
Bedding Store 	Harley-Davidson Dealer 	Registration Office
Bedroom Furniture Store 	Hat Shop 	Registry Office
Gyudon Restaurant 	Haunted House 	Rehabilitation Center
Beer Distributor 	Haute Couture Fashion House 	Reiki Therapist
Beer Garden 	Haute French Restaurant 	Religious Book Store
Beer Hall 	Hawaiian Goods Store 	Religious Destination
Beer Store 	Hawaiian Restaurant 	Religious Goods Store
Belgian Restaurant 	Hawker Centre 	Religious Institution
Belt Shop 	Hawker Stall 	Religious Organization
Berry Restaurant 	Hay Supplier 	Religious School
Betting Agency 	Head Start Center 	Religious Seminary
Beverage Distributor 	Health and Beauty Shop 	Remodeler
Bible Church 	Health Consultant 	Renault dealer
Bicycle Club 	Health Food Restaurant 	Renter’s Insurance Agency
Bicycle Rack 	Health Food Store 	Repair Service
Bicycle Rental Service 	Health Insurance Agency 	Reproductive Health Clinic
Bicycle Repair Shop 	Health Resort 	Reptile Store
Bike Sharing Station 	Health Spa 	Research and Product Development
Bicycle Store 	Hearing Aid Repair Service 	Research Engineer
Bicycle Wholesale 	Hearing Aid Store 	Research Foundation
Bikram Yoga Studio 	Heart Hospital 	Research Institute
Bilingual School 	Heating Contractor 	Resident Registration Office
Billiards Supply Store 	Heating Equipment Supplier 	Residential College
Bingo Hall 	Heating Oil Supplier 	Residents Association
Biochemical Supplier 	Height Works 	Resort
Biochemistry Lab 	Helicopter Charter 	Rest Stop
Biofeedback Therapist 	Helicopter Tour Agency 	Restaurant
Biotechnology Company 	Heliport 	Brasserie
Biotechnology Engineer 	Helium Gas Supplier 	Restaurant Supply Store
Bird Control Service 	Helpline 	Resume Service
Bird Shop 	Hematologist 	Retail Space Rental Agency
Bird Watching Area 	Herb Shop 	Retaining Wall Supplier
Birth Center 	Herbal Medicine Store 	Retirement Community
Birth Certificate Service 	Herbalist 	Retirement Home
Birth Control Center 	Heritage Building 	Retreat Center
Bistro 	Heritage Museum 	Rheumatologist
Blacksmith 	Heritage Preservation 	Rice Cracker Shop
Blast Cleaning Service 	High Ropes Course 	Rice Mill
Blind School 	High School 	Rice Restaurant
Blinds Shop 	Higher Secondary School 	Rice Shop
Blood Bank 	Highway Patrol 	Rice Wholesaler
Blood Donation Center 	Hiking Area 	River Port
Blood Testing Service 	Hindu Priest 	Road Construction Company
Blueprint Service 	Hindu Temple 	Road Construction Machine Repair Service
Blues Club 	Hip Hop Dance Class 	Road Cycling
BMW Dealer 	Hispanic Church 	Road Safety Town
BMW Motorcycle Dealer 	Historical Landmark 	Roads Ports and Canals Engineers Association
BMX Club 	Historical Place Museum 	Rock Climbing
BMX Park 	Historical Society 	Rock Climbing Gym
BMX Track 	History Museum 	Rock Climbing Instructor
Board Game Club 	HIV Testing Center 	Rock Landscaping Contractor
Board of Education 	Hoagie Restaurant 	Rock Music Club
Board of Trade 	Hobby Store 	Rock Shop
Boarding House 	Hockey Club 	Rodeo
Boarding School 	Hockey Field 	Rolled Metal Products Supplier
Boat Accessories Supplier 	Hockey Rink 	Roller Coaster
Boat Builders 	Hockey Supply Store 	Roller Skating Club
Boat Club 	Holding Company 	Roller Skating Rink
Boat Cover Supplier 	Holiday Accommodation Service 	Roman Restaurant
Boat Dealer 	Holiday Apartment Rental 	Romanian Restaurant
Boat Ramp 	Holiday Home 	Roofing Contractor
Boat Rental Service 	Holiday Park 	Roofing Supply Store
Boat Repair Shop 	Holistic Medicine Practitioner 	Roommate Referral Service
Boat Storage Facility 	Home Automation Company 	Rowing Area
Boat Tour Agency 	Home Builder 	Rowing Club
Boat Trailer Dealer 	Home Cinema Installation 	Rsl Club
Boatel 	Home Goods Store 	Rubber Products Supplier
Boating Instructor 	Home Hairdresser 	Rubber Stamp Store
Bocce Ball Court 	Home Health Care Service 	Rug Store
Body Piercing Shop 	Home Help 	Rugby
Body Shaping Class 	Home Help Service Agency 	Rugby Club
Boiler Manufacturer 	Home Improvement Store 	Rugby Field
Boiler Supplier 	Home Inspector 	Rugby League Club
Bonesetting House 	Home Insurance Agency 	Rugby Store
Bonsai Plant Supplier 	Home Theater Store 	Running Store
Book Publisher 	Homekill Service 	Russian Orthodox Church
Book Store 	Homeless Service 	Russian Restaurant
Bookbinder 	Homeless Shelter 	Rustic Furniture Store
Bookkeeping Service 	Homeopath 	RV Dealer
Bookmaker 	Homeopathic Pharmacy 	RV Park
Books Wholesaler 	Homeowners’ Association 	Recreational Vehicle Rental Agency
Boot Camp 	Honda Dealer 	RV Repair Shop
Boot Repair Shop 	Honduran Restaurant 	RV Storage Facility
Boot Store 	Honey Farm 	RV Supply Store
Border Crossing Station 	Hong Kong Style Fast Food Restaurant 	Saab Dealer
Border Guard 	Hookah Bar 	Sacem
Botanical Garden 	Hookah Store 	Saddlery
Bottle & Can Redemption Center 	Horse Boarding Stable 	Safe & Vault Shop
Bottled Water Supplier 	Horse Breeder 	Safety Equipment Supplier
Bouncy Castle Hire 	Horse Rental Service 	Sailing Club
Boutique 	Horse Riding Field 	Sailing Event Area
Boutique Hotel 	Horse Riding School 	Sailing School
Bowling Alley 	Horse Trailer Dealer 	Sailmaker
Bowling Club 	Horse Trainer 	Sake Brewery
Bowling Supply Shop 	Horseback Riding Service 	Salad Shop
Box Lunch Supplier 	Horse Transport Supplier 	Salsa Bar
Boxing Club 	Horseshoe Smith 	Salsa Classes
Boxing Gym 	Horsestable Studfarm 	Salvadoran Restaurant
Boxing Ring 	Hose Supplier 	Salvage Dealer
Boys’ High School 	Hospice 	Salvage Yard
BPO Company 	Hospital 	Samba School
BPO Placement Agency 	Hospital Equipment and Supplies 	Sambo School
Brake Shop 	Hospital Department 	Sambodrome
Brazilian Restaurant 	Hospitality and Tourism School 	Sand & Gravel Supplier
Breakfast Restaurant 	Hospitality High School 	Sand Plant
Brewery 	Host Club 	Sandblasting Service
Brewing Supply Store 	Hostel 	Sandwich Shop
Brewpub 	Hot Bedstone Spa 	Sanitary Inspection
Brick Manufacturer 	Hot Dog Restaurant 	Sanitation Service
Bricklayer 	Hot Dog Stand 	Satellite Communication Service
Bridal Shop 	Hot Pot Restaurant 	Saturn Dealer
Bridge 	Hot Spring Hotel 	Sauna
Bridge Club 	Hot Tub Repair Service 	Sauna Club
British Restaurant 	Hot Tub Store 	Sauna Store
Brunch Restaurant 	Hot Water System Supplier 	Savings Bank
Bubble Tea 	Hotel 	Saw Mill
Buddhist Supplies Store 	Hotel Management School 	Saw Sharpening Service
Buddhist Temple 	Hotel Supply Store 	Scaffolder
Budget Hotel 	House Cleaning Service 	Scaffolding Rental Service
Budget Japanese Inn 	House Clearance Service 	Scale Model Club
Buffet Restaurant 	House Sitter 	Model Shop
Buick Dealer 	House Sitter Agency 	Scale Repair Service
Building Consultant 	Houseboat Rental Service 	Scale Supplier
Building Design Company 	Household Chemicals Supplier 	Scandinavian Restaurant
Building Equipment Hire Service 	Household Goods Wholesaler 	Scenic Spot
Building Firm 	Housing Association 	School
Building Inspector 	Housing Authority 	School Administrator
Building Materials Market 	Housing Complex 	School Bus Service
Building Materials Store 	Housing Cooperative 	School Center
Building Materials Supplier 	Housing Development 	School District Office
Building Restoration Service 	Housing Society 	School For The Deaf
Building Society 	Housing Utility Company 	School House
Chartered Surveyor 	Hua Gong Shop 	School Lunch Center
Bulgarian Restaurant 	Hua Hui Market Place 	School Supply Store
Bullring 	Hua Niao Market Place 	School Youth Hostel
Bungee Jumping Center 	Hub Cap Supplier 	Science Academy
Burglar Alarm Store 	Huissier 	Science Museum
Burmese Restaurant 	Human Resource Consulting 	Scientific Equipment Supplier
Burrito Restaurant 	Hunan Restaurant 	Scooter Rental Service
Bus and Coach Company 	Hungarian Restaurant 	Scooter Repair Shop
Bus Charter 	Hunting and Fishing Store 	Scout Hall
Bus Company 	Hunting Area 	Scout Home
Bus Ticket Agency 	Hunting Club 	Scouting
Bus Tour Agency 	Hunting Preserve 	Scrap Metal Dealer
Business Administration Service 	Hunting Store 	Scrapbooking Store
Business Broker 	HVAC Contractor 	Screen Printer
Business Center 	Hydraulic Engineer 	Screen Printing Shop
Business Development Service 	Hydraulic Equipment Supplier 	Screen Printing Supply Store
Business Hotel 	Hydraulic Repair Service 	Screen Repair Service
Business Management Consultant 	Hydroelectric Power Plant 	Screen Store
Business Networking Company 	Hydroponics Equipment Supplier 	Screw Supplier
Business Park 	Hygiene Articles Wholesaler 	SCUBA Instructor
Business School 	Hygiene Station 	SCUBA Tour Agency
Business to Business Service 	Hypermarket 	Sculptor
Butane Gas Supplier 	Hypnotherapy Service 	Sculpture
Butcher Shop 	Hyundai Dealer 	Sculpture Museum
Butcher Shop Deli 	Ice Cream Equipment Supplier 	Seafood Donburi Restaurant
Butsudan Store 	Ice Cream Shop 	Seafood Farm
Cabaret Club 	Ice Hockey Club 	Seafood Market
Cabin Rental Agency 	Ice Skating Club 	Seafood Restaurant
Cabinet Maker 	Ice Skating Instructor 	Seafood Wholesaler
Cabinet Store 	Ice Skating Rink 	Seal Shop
Cable Company 	Ice Supplier 	Seaplane Base
Cadillac Dealer 	Icelandic Restaurant 	Seasonal Goods Store
Cafe 	Icse School 	Second Hand Store
Cafeteria 	Idol Manufacturer 	Secondary School Three
Cajun Restaurant 	Image Consultant 	Security Guard Service
Cake Decorating Equipment Shop 	Imax Theater 	Security Service
Cake Shop 	Immigration & Naturalization Service 	Security System Installer
Californian Restaurant 	Immigration Attorney 	Security System Supplier
Call Center 	Immigration Detention Centre 	Seed Supplier
Call Shop 	Immunologist 	Seitai
Calligraphy Lesson 	Impermeabilization Service 	Self-Catering Accommodation
Calvary Chapel Church 	Import Export Company 	Self Defense School
Cambodian Restaurant 	Importer 	Self Service Car Wash
Camera Repair Shop 	Incense Supplier 	Self Service Restaurant
Camera Store 	Incineration Plant 	Self-Storage Facility
Camp 	Income Protection Insurance 	Semi Conductor Supplier
Camper Shell Supplier 	Income Tax Help Association 	Seminary
Campground 	Indian Grocery Store 	Senior Citizen Center
Camping Farm 	Indian Muslim Restaurant 	Aged Care
Camping Store 	Indian Restaurant 	Senior High School
Pacific Northwest Restaurant (Canada) 	Indonesian Restaurant 	Septic System Service
Canadian Restaurant 	Indoor Cycling 	Serbian Restaurant
Cancer Treatment Center 	Indoor Golf Course 	Serviced Accommodation
Candle Store 	Indoor Lodging 	Seventh-day Adventist Church
Candy Store 	Indoor Playground 	Sewage Disposal Service
Cane Furniture Store 	Indoor Snowcenter 	Sewage Treatment Plant
CBD store 	Indoor Swimming Pool 	Sewing Company
Cannery 	Industrial Area 	Sewing Machine Repair Service
Canoe and Kayak Club 	Industrial Chemicals Wholesaler 	Sewing Machine Store
Canoe & Kayak Rental Service 	Industrial Consultant 	Sewing Shop
Canoe & Kayak Store 	Industrial Design Company 	Sexologist
Canoe & Kayak Tour Agency 	Industrial Door Supplier 	Seychelles Restaurant
Canoeing Area 	Industrial Engineer 	Sukiyaki and Shabu Shabu Restaurant
Cantabrian Restaurant 	Industrial Engineers Association 	Shabu-shabu Restaurant
Cantonese Restaurant 	Industrial Equipment Supplier 	Shan Dong Restaurant
Cape Verdean Restaurant 	Industrial Framework Supplier 	Shanghainese Restaurant
Capital 	Industrial Gas Supplier 	Sharpening Service
Capoeira School 	Industrial Real Estate Agency 	Shed Builder
Capsule Hotel 	Industrial Supermarket 	Sheep Shearer
Car Accessories Store 	Industrial Technical Engineers Association 	Sheepskin and Wool Products Supplier
Car Alarm Supplier 	Industrial Vacuum Equipment Supplier 	Sheepskin Coat Store
Car Battery Store 	Infectious Disease Physician 	Sheet Metal Contractor
Car Dealer 	Infiniti Dealer 	Sheet Music Store
Car Detailing Service 	Information Bureau 	Shelter
Car Factory 	Information Services 	Sheltered Housing
Car Finance and Loan Company 	Inn 	Shelving Store
Car Inspection Station 	Insolvency Service 	Sheriff’s Department
Car Leasing Service 	Institute of Geography and Statistics 	Shinkin Bank
Car Manufacturer 	Instrumentation Engineer 	Shinto Shrine
Car Racing Track 	Insulation Contractor 	Ship Building
Car Rental Agency 	Insulation Materials Store 	Shipbuilding and Repair Company
Car Repair and Maintenance 	Insulator Supplier 	Shipping and Mailing Service
Car Security System Installer 	Insurance Agency 	Shipping Company
Car Service 	Insurance Attorney 	Shipping Equipment Industry
Car Sharing Location 	Insurance Broker 	Shipping Service
Car Stereo Store 	Insurance Company 	Shipyard
Car Wash 	Insurance School 	Shochu Brewery
Carabinieri Police 	Intellectual Property Registry 	Shoe Factory
Cardiologist 	Interior Architect Office 	Shoe Repair Shop
Career Guidance Service 	Interior Construction Contractor 	Shoe Shining Service
Caribbean Restaurant 	Interior Designer 	Shoe Store
Carnival Club 	Interior Door 	Footwear Wholesaler
Carpenter 	Interior Fitting Contractor 	Shogi Lesson
Carpet Cleaning Service 	Interior Plant Service 	Shooting Event Area
Carpet Installer 	Internal Medicine Ward 	Shooting Range
Carpet Manufacturer 	International Airport 	Shop Supermarket Furniture Store
Carpet Store 	International School 	Shopfitter
Carpet Wholesaler 	International Trade Consultant 	Shopping Mall
Carpool 	Internet Cafe 	Short Term Apartment Rental Agency
Carport and Pergola Builder 	Internet Marketing Service 	Shower Door Shop
Carriage Ride Service 	Internet Service Provider 	Shower Door Supplier
Carvery 	Internet Shop 	Shredding Service
Cash and Carry Wholesaler 	Internist 	Shrimp Farm
Casino 	Investment Bank 	Shrine
Casket Service 	Investment Company 	Sichuan Restaurant
Castilian Restaurant 	Investment Service 	Sicilian Restaurant
Castle 	Invitation Printing Service 	Siding Contractor
Castle Hotel 	Irish Goods Store 	Sightseeing Tour Agency
Syokudo and Teishoku Restaurant 	Irish Pub 	Sign Shop
Conveyor Belt Sushi Restaurant 	Irish Restaurant 	Gurudwara
Cat Hostel 	Iron Steel Contractor 	Silk Plant Shop
Catalonian Restaurant 	Iron Ware Dealer 	Silk Store
Catering Food and Drink Supplier 	Iron Works 	Silversmith
Caterer 	Irrigation Equipment Supplier 	Singaporean Restaurant
Cathedral 	Israeli Restaurant 	Singing Telegram Service
Catholic Cathedral 	Isuzu Dealer 	Single Sex Secondary School
Catholic Church 	Italian Grocery Store 	Singles Organization
Catholic School 	Italian Restaurant 	Sixth Form College
Cattery 	IUP 	Skate Sharpening Service
Cattle Farm 	Institute of Technology 	Skate Shop
Cattle Market 	Jaguar Dealer 	Skateboard Park
CBSE School 	Jain Temple 	Skateboard Shop
CD Store 	Jamaican Restaurant 	Skating Instructor
Ceiling Supplier 	Janitorial Equipment Supplier 	Skeet Shooting Range
Cell Phone Accessory Store 	Janitorial Service 	Kushiage and Kushikatsu Restaurant
Cell Phone Store 	Authentic Japanese Restaurant 	Ski Club
Cement Manufacturer 	Japanese Cheap Sweets Shop 	Ski Rental Service
Cement Supplier 	Japanese Confectionary Shop 	Ski Repair Service
Cemetery 	Japanese Curry Restaurant 	Ski Resort
Central American Restaurant 	Japanese Delicatessen 	Ski School
Central Authority 	Japanese Grocery Store 	Ski Shop
Central Bank 	Ryotei Restaurant 	Skin Care Clinic
Ceramic Manufacturer 	Japanese Hot Pot Restaurant 	Skin Care Products Vending Machine
Ceramics Wholesaler 	Japanese Inn With Hot Spring 	Skittle Alley
Certification Agency 	Japanese Inns 	Skittle Club
Certified Public Accountant 	Izakaya Restaurant 	Skydiving Center
Chalet 	Japanese Language Instructor 	Skylight Contractor
Chamber of Agriculture 	Japanese Regional Restaurant 	Slaughterhouse
Chamber of Commerce 	Japanese Restaurant 	Sleep Clinic
Chamber of Handicrafts 	Japanese Steakhouse 	Small Appliance Repair Service
Champon Noodle Restaurant 	Japanese Sweets Restaurant 	Small Claims Assistance Service
Chanko Restaurant 	Japanized Western Restaurant 	Small Engine Repair Service
Chapel 	Jazz Club 	Small Plates Restaurant
Charcuterie 	Jeep Dealer 	Smart Shop
Charity 	Jehovah’s Witness Kingdom Hall 	Smog Inspection Station
Charter School 	Jeweler 	Snack Bar
Chartered Accountant 	Jewelry Appraiser 	Snow Removal Service
Check Cashing Service 	Jewelry Buyer 	Snowboard Rental Service
Cheese Manufacturer 	Jewelry Designer 	Snowboard Shop
Cheese Shop 	Jewelry Engraver 	Snowmobile Dealer
Cheesesteak Restaurant 	Jewelry Equipment Supplier 	Snowmobile Rental Service
Chemical Engineer 	Jewelry Exporter 	Soapland
Chemical Exporter 	Jewellery Manufacturer 	Soba Noodle Shop
Chemical Manufacturer 	Jewelry Repair Service 	Soccer Club
Chemical Plant 	Jewelry Store 	Soccer Field
Chemical Wholesaler 	Jewish Restaurant 	Soccer Practice
Chemistry Faculty 	Jiang Su Restaurant 	Soccer Store
Chemistry Lab 	Joiner 	Social Club
Chesapeake Restaurant 	Judicial Auction 	Social Security Attorney
Chess and Card Club 	Judicial Scrivener 	Social Security Financial Department
Chess Club 	Judo Club 	Social Security Office
Chess Instructor 	Judo School 	Social Services Organization
Chevrolet Dealer 	Juice Shop 	Social Welfare Center
Chicken Hatchery 	Jujitsu School 	Social Worker
Chicken Restaurant 	Junior College 	Societe de Flocage
Chicken Shop 	Junk Dealer 	Sod Supplier
Chicken Wings Restaurant 	Junk Store 	Sofa Store
Child Care Agency 	Junkyard 	Soft Drinks Shop
Child Health Care Centre 	Justice Department 	Suppon Restaurant
Child Psychologist 	Jute Exporter 	Softball Club
Childbirth Class 	Jute Mill 	Softball Field
Children’s Amusement Center 	Juvenile Detention Center 	Software Company
Children Hall 	Kabaddi Club 	Software Training Institute
Children Policlinic 	Kaiseki Restaurant 	Soil Testing Service
Childrens Book Store 	Karaoke 	Sokol House
Childrens Cafe 	Karaoke Bar 	Solar Energy Company
Children’s Clothing Store 	Karaoke Equipment Rental Service 	Solar Energy Contractor
Childrens Club 	Karate Club 	Solar Energy Equipment Supplier
Childrens Farm 	Karate School 	Solar Hot Water System Supplier
Children’s Furniture Store 	Kashmiri Restaurant 	Solar Photovoltaic Power Plant
Childrens Home 	Kawasaki Motorcycle Dealer 	Solid Fuel Company
Children’s Hospital 	Kazakhstani Restaurant 	Solid Waste Engineer
Childrens Library 	Kebab Shop 	Soul Food Restaurant
Children’s Museum 	Kennel 	Soup Kitchen
Childrens Party Buffet 	Kerosene Supplier 	Soup Restaurant
Children’s Party Service 	Key Duplication Service 	Soup Shop
Childrens Store 	Kia Dealer 	South African Restaurant
Childrens Theater 	Kickboxing School 	South American Restaurant
Chilean Restaurant 	Kilt Shop and Hire 	South Asian Restaurant
Chimney Services 	Kimono Store 	Southeast Asian Restaurant
Chimney Sweep 	Kindergarten 	Southern Italian Restaurant
Chinaware Store 	Kinesiologist 	Southern Restaurant (US)
Chinese Language Instructor 	Kiosk 	Southwest France Restaurant
Chinese Language School 	Kitchen Furniture Store 	Southwestern Restaurant (US)
Chinese Medical Hospital 	Kitchen Remodeler 	Souvenir Manufacturer
Chinese Medicine Clinic 	Kitchen Supply Store 	Souvenir Store
Chinese Medicine Store 	Kite Shop 	Soy Sauce Maker
Chinese Noodle Restaurant 	Knife Manufacturing 	Spa
Chinese Pastry 	Knife Store 	Spa and Health Club
Chinese Restaurant 	Knit Shop 	Spa Garden
Chinese Supermarket 	Knitting Instructor 	Spa Resort
Chinese Takeaway 	Knitwear Manufacturer 	Spa Town
Chinese Tea House 	Korean Barbecue Restaurant 	Spanish Language School
Chiropractor 	Korean Beef Restaurant 	Spanish Restaurant
Chocolate Artisan 	Korean Church 	Special Education School
Chocolate Cafe 	Korean Grocery Store 	Specialist Hospital
Chocolate Factory 	Korean Restaurant 	Specialized Clinic
Chocolate Shop 	Korean Rib Restaurant 	Specialized hospital
Choir 	Kosher Grocery Store 	Speech Pathologist
Chophouse Restaurant 	Kosher Restaurant 	Sperm Bank
Christian Book Store 	Kung Fu School 	Spice Store
Christian Church 	Kushiyaki Restaurant 	Spices Exporter
Christian College 	Kyoto Style Japanese Restaurant 	Spices Wholesalers
Christmas Market 	Labor Relations Attorney 	Spiritist Center
Christmas Store 	Labor Union 	Sport Tour Agency
Christmas Tree Farm 	Laboratory 	Sporting Goods Store
Chrysler Dealer 	Laboratory Equipment Supplier 	Sports Accessories Wholesaler
Church 	Labour Club 	Sports Bar
Church of Christ 	Ladder Supplier 	Sports Card Store
Church of Jesus Christ of Latter-day Saints 	Laminating Equipment Supplier 	Sports Club
Church of the Nazarene 	Lamination Service 	Sports Complex
Church Supply Store 	Lamp Repair Service 	Sports Equipment Rental Service
Churreria 	Lamp Shade Supplier 	Sports Massage Therapist
Cider Bar 	Land Allotment 	Sports Medicine Clinic
Cider Mill 	Land Planning Authority 	Sports Medicine Physician
Cigar Shop 	Land Reform Institute 	Sports Memorabilia Store
Cinema Equipment Supplier 	Land Rover Dealer 	Sports Nutrition Store
Circular Distribution Service 	Land Surveying Office 	Sports School
Circus 	Land Surveyor 	Sportswear Store
Citizen Information Bureau 	Landscape Architect 	Sportwear Manufacturer
Citizens Advice Bureau 	Landscape Designer 	Spring Supplier
City Administration 	Landscape Lighting Designer 	Squash Club
City Clerk’s Office 	Landscaper 	Squash Court
City Courthouse 	Landscaping Supply Store 	Sri Lankan Restaurant
City Department of Environment 	Language School 	Stable
City Department of Public Safety 	Laotian Restaurant 	Stadium
City Department of Transportation 	Lapidary 	Stage
City District Office 	Laser Cutting Service 	Stage Lighting Equipment Supplier
City Employment Department 	Laser Equipment Supplier 	Stained Glass Studio
City Government Office 	Laser Hair Removal Service 	Stainless Steel Plant
City or Town Hall 	Laser Tag Center 	Stair Contractor
City Hospital 	LASIK Surgeon 	Stall Installation Service
City Park 	Latin American Restaurant 	Stamp Collectors Club
City pillar shrine 	Laundromat 	Stamp Shop
City Tax Office 	Laundry 	Stand Bar
Civic Center 	Laundry Service 	Staple Food Package
Civil Defence 	Law Book Store 	State
Civil Engineer 	Law Firm 	State Archive
Civil Engineering Company 	Law Library 	State Department Agricultural Development
Civil Examinations Academy 	Law School 	State Department Agriculture Food Supply
Civil Law Attorney 	Lawn Bowls Club 	State Department Civil Defense
Civil Police 	Lawn Care Service 	State Department Communication
Civil Registry 	Lawn Equipment Rental Service 	State Department Finance
Class 	Lawn Irrigation Equipment Supplier 	State Department for Social Development
Classified Ads Newspaper Publisher 	Lawn Mower Repair Service 	State Department Housing and Urban Development
Cleaners 	Lawn Mower Store 	State Department of Environment
Cleaning Products Supplier 	Lawn Sprinkler System Contractor 	State Department of Tourism
Cleaning Service 	Lawyer 	State Department of Transportation
Clergyman 	Lawyers Association 	State Department Science Technology
Clock Repair Service 	Leagues Club 	State Department Social Defense
Clock Watch Maker 	Learner Driver Training Area 	State Dept of Culture
Closed Circuit Television 	Learning Center 	State Dept of Sports
Clothes and Fabric Manufacturer 	Leasing Service 	State Employment Department
Clothes and Fabric Wholesaler 	Leather Cleaning Service 	State Government Office
Clothes Market 	Leather Coats Store 	State Liquor Store
Clothing Alteration Service 	Leather Exporter 	State Office of Education
Clothing Store 	Leather Goods Manufacturer 	State Owned Farm
Clothing Supplier 	Leather Goods Store 	State Park
Clothing Wholesale Market Place 	Leather Goods Supplier 	State Police
Clothing Wholesaler 	Leather Goods Wholesaler 	State Social Development
Club 	Leather Repair Service 	Stationery Manufacturer
CNG Fittment Center 	Leather Wholesaler 	Stationery Store
Coaching Center 	Lebanese Restaurant 	Stationery Wholesaler
Coal Exporter 	Legal Affairs Bureau 	Statuary
Coal Supplier 	Legal Aid Office 	Std Clinic
Coalfield 	Legal Services 	STD Testing Service
Coast Guard Station 	Leisure Centre 	Steak House
Coat Wholesaler 	Lexus Dealer 	Steamboat Restaurant
Cocktail Bar 	Library 	Steamed Bun Shop
Co-ed School 	License Bureau 	Steel Construction Company
Coffee Machine Supplier 	License Plate Frames Supplier 	Steel Distributor
Coffee Roasters 	Lido 	Steel Drum Supplier
Coffee Shop 	Life Coach 	Steel Erector
Coffee Store 	Life Insurance Agency 	Steel Fabricator
Coffee Vending Machine 	Light Bulb Supplier 	Steel Framework Contractor
Coffee Wholesaler 	Lighting Consultant 	Steelwork Design Company
Coffin Supplier 	Lighting Contractor 	Steelwork Manufacturer
Coin Dealer 	Lighting Manufacturer 	Stereo Rental Store
Coin Operated Laundry Equipment Supplier 	Lighting Store 	Stereo Repair Service
Coin Operated Locker 	Lighting Wholesaler 	Home Audio Store
Cold Cut Store 	Limousine Service 	Sticker Manufacturer
Cold Noodle Restaurant 	Lincoln Mercury Dealer 	Stitching Class
Cold Storage Facility 	Line Marking Service 	Stock Broker
Collectibles Store 	Linens Store 	Stock Exchange Building
College 	Lingerie Manufacturer 	Stone Carving
College of Agriculture 	Lingerie Store 	Stone Cutter
Colombian Restaurant 	Lingerie Wholesaler 	Stone Supplier
Comedy Club 	Linoleum Store 	Storage Facility
Comic Book Store 	Lion Dance Troupe 	Store
Comic Cafe 	Liquidator 	Store Equipment Supplier
Commercial Agent 	Liquor Store 	Stove Builder
Commercial Cleaning Service 	Liquor Wholesaler 	Stringed instrument maker
Commercial Printer 	Literacy Program 	Structural Engineer
Commercial Real Estate Agency 	Lithuanian Restaurant 	Stucco Contractor
Commercial Real Estate Inspector 	Little League Club 	Student Career Counseling Office
Commercial Refrigeration 	Little League Field 	Student Dormitory
Commercial Refrigerator Supplier 	Live Music Bar 	Student Housing Center
Commissioner for Oaths 	Live Music Venue 	Student Union
Communications Central 	Livery Company 	Students Parents Association
Community Center 	Livestock Auction House 	Students Support Association
Community College 	Livestock Breeder 	Study at Home School
Community Garden 	Livestock Dealer 	Studying Center
Community Health Centre 	Livestock Producer 	Stylist
Community School 	Loan Agency 	Subaru Dealer
Company Registry 	Lobster Restaurant 	Suburban Train Line
Computer Accessories Store 	Local Government Office 	Sugar Factory
Computer Club 	Local History Museum 	Sugar Shack
Computer Consultant 	Local Medical Services 	Sukiyaki Restaurant
Computer Desk Store 	Locks Supplier 	Summer Camp
Computer Hardware Manufacturer 	Locksmith 	Summer Toboggan Run
Computer Networking Center 	Lodge 	Sundae Restaurant
Computer Repair Service 	Lodging 	Sunglasses Store
Computer Security Service 	Log Cabins 	Sunroom Contractor
Computer Service 	Log Home Builder 	Super Public Bath
Computer Software Store 	Logging Contractor 	Superannuation Consultant
Computer Store 	Logistics Service 	Superfund Site
Computer Support and Services 	Loss Adjuster 	Supermarket
Computer Training School 	Lost Property Office 	Surf Lifesaving Club
Computer Wholesaler 	Lottery Retailer 	Surf School
Concert Hall 	Lottery Shop 	Surf Shop
Concrete Contractor 	Lounge 	Surgeon
Concrete Factory 	Love Hotel 	Surgical Center
Concrete Metal Framework Supplier 	Low Emission Zone 	Surgical Products Wholesaler
Concrete Product Supplier 	Low Income Housing Program 	Surgical Supply Store
Condiments Supplier 	LPG Conversion 	Surinamese Restaurant
Condominium Complex 	Luggage Repair Service 	Surplus Store
Condominium Rental Agency 	Luggage Store 	Surveyor
Confectionery 	Luggage Wholesaler 	Sushi Restaurant
Confectionery Wholesaler 	Lumber Store 	Suzuki Dealer
Conference Center 	Lunch Restaurant 	Suzuki Motorcycle Dealer
Conference Hotel 	Lutheran Church 	Swedish Restaurant
Congregation 	Luxury Hotel 	Swim Club
Conservation Department 	Lyceum 	Swimming Basin
Conservative Club 	Lymph Drainage Therapist 	Swimming Competition
Conservative Synagogue 	Machine Construction 	Swimming Facility
Conservatory Construction Contractor 	Machine Knife Supplier 	Swimming Instructor
Conservatory of Music 	Machine Maintenance 	Swimming Lake
Conservatory Supply & Installation 	Machine Repair Service 	Swimming Pool
Consignment Shop 	Machine Shop 	Swimming Pool Contractor
Construction and Maintenance Office 	Machine Workshop 	Swimming Pool Repair Service
Construction Company 	Machinery Parts Manufacturer 	Swimming Pool Supply Store
Construction Equipment Supplier 	Machining Manufacturer 	Swimming School
Construction Machine Dealer 	Macrobiotic Restaurant 	Swimwear Store
Construction Machine Rental Service 	Madrilian Restaurant 	Swiss Restaurant
Construction Material Wholesaler 	Magazine Publisher 	Synagogue
Consultant 	Magazine Store 	Synchronized Swimming
Consumer Advice Center 	Magic Store 	Syrian Restaurant
Contact Lenses Supplier 	Magician 	T-shirt Company
Container Service 	Mah Jong House 	T-shirt Store
Container Supplier 	Mailbox Rental Service 	Table & Chair Rental Service
Container Terminal 	Mailbox Supplier 	Table Tennis Club
Containers Supplier 	Mailing Machine Supplier 	Table Tennis Facility
Contemporary Louisiana Restaurant 	Mailing Service 	Table Tennis Supply Store
Continental Restaurant 	Main Customs Office 	Tack Shop
Contractor 	Make-up Artist 	Taco Restaurant
Convenience Store 	Malaysian Restaurant 	Tae Kwon Do Comp Area
Convenience Stores Organization 	Male Hospital 	Taekwondo School
Convention Center 	Maltese Restaurant 	Tag Agency
Convention Information Bureau 	Mammography Service 	Tai Chi School
Conveyancer 	Management School 	Tailor
Cookie Shop 	Mandarin Restaurant 	Taiwanese Restaurant
Cooking Class 	Manor House 	Takoyaki Restaurant
Cooking School 	Manufactured Home Transporter 	Talent Agency
Cooling Plant 	Manufacturer 	Tamale Shop
Copier Repair Service 	Maori Organization 	Tannery
Copper Supplier 	Map Store 	Tanning Salon
Coppersmith 	Mapping Service 	Taoist Temple
Copy Shop 	Marae 	Tapas Bar
Copying Supply Store 	Marble Contractor 	Tapas Restaurant
Corporate Campus 	Marble Supplier 	Tatami Store
Corporate Entertainment Service 	Marche Restaurant 	Tattoo and Piercing Shop
Corporate Gift Supplier 	Marina 	Tattoo Removal Service
Corporate Office 	Marine Engineer 	Tattoo Shop
Correctional Services Department 	Marine Self Defense Force 	Tax Assessor
Cosmetic Dentist 	Marine Supply Store 	Tax Attorney
Cosmetic Products Manufacturer 	Marine Surveyor 	Tax Collector’s Office
Cosmetics and Parfumes Supplier 	Maritime Museum 	Tax Consultant
Cosmetics Industry 	Market 	Tax Department
Cosmetics Store 	Market Operator 	Tax Preparation
Cosmetics Wholesaler 	Market Researcher 	Tax Preparation Service
Cosplay Cafe 	Marketing Agency 	Taxi Service
Costa Rican Restaurant 	Marketing Consultant 	Taxi Stand
Costume Jewelry Shop 	Markmens Clubhouse 	Taxidermist
Costume Rental Service 	Marquee Hire Service 	Tb Clinic
Costume Store 	Marriage Celebrant 	Tea Exporter
Cottage 	Marriage Counselor 	Tea House
Cottage Rental 	Marriage License Bureau 	Tea Manufacturer
Cottage Village 	Martial Arts Club 	Tea Market Place
Cotton Exporter 	Martial Arts School 	Tea Store
Cotton Mill 	Martial Arts Supply Store 	Tea Wholesaler
Cotton Supplier 	Masonic Center 	Teacher College
Council 	Masonry Contractor 	Technical School
Counselor 	Masonry Supply Store 	Technical Service
Countertop Store 	Massage School 	Technical University
Country Club 	Massage Spa 	Technology Museum
Country Food Restaurant 	Massage Supply Store 	Technology Park
Country House 	Massage Therapist 	Teeth Whitening Service
Country Park 	Match Box Manufacturer 	Telecommunication School
County Government Office 	Material Handling Equipment Supplier 	Telecommunications Contractor
Courier Service 	Maternity Hospital 	Telecommunications Engineer
Cours de Capoeira 	Maternity Store 	Telecommunications Equipment Supplier
Cours de Surf 	Mathematics School 	Telecommunications Service Provider
Court Executive Officer 	Mattress Store 	Telemarketing Service
Court Reporter 	Mausoleum Builder 	Telephone Answering Service
Couscous Restaurant 	Mazda Dealer 	Telephone Company
Couture Store 	Meal Delivery 	Telephone Exchange
Coworking Space 	Meal Takeaway 	Telescope Store
Crab House 	Measuring Instruments Supplier 	Television Repair Service
Craft Centre 	Meat Packer 	Television Station
Craft Store 	Meat Processor 	Temp Agency
Cramming School 	Meat Products 	Tempura Donburi Restaurant
Crane Dealer 	Meat Dish Restaurant 	Tempura Restaurant
Crane Rental Agency 	Meat Wholesaler 	Tenant Ownership
Crane Service 	Mechanic 	Tenant’s Union
Craniosacral Therapy 	Mechanical Contractor 	Tennis Club
Creche 	Mechanical Engineer 	Tennis Court
Credit Counseling Service 	Mechanical Plant 	Tennis Court Construction Company
Credit Reporting Agency 	Media and Information Sciences Faculty 	Tennis Instructor
Credit Union 	Media Company 	Tennis Store
Cremation Service 	Media Consultant 	Tent Rental Service
Creole Restaurant 	Media House 	Teppanyaki Restaurant
Crêperie 	Mediation Service 	Tex-Mex Restaurant
Cricket Club 	Medical Billing Service 	Textile Engineer
Cricket Ground 	Medical Book Store 	Textile Exporter
Cricket Shop 	Medical Center 	Textile Mill
Crime Victim Service 	Medical Certificate Service 	Thai Massage Therapist
Criminal Justice Attorney 	Medical Clinic 	Thai Restaurant
Croatian Restaurant 	Medical Diagnostic Imaging Center 	Theater Company
Crop Grower 	Medical Equipment Manufacturer 	Theater Production
Croquet Club 	Medical Equipment Supplier 	Theater Supply Store
Cruise Agency 	Medical Examiner 	Theatrical Costume Supplier
Cruise Line Company 	Medical Group 	Theme Park
Cruise Terminal 	Medical Laboratory 	Thermal Baths
Crushed Stone Supplier 	Medical Office 	Thermal Energy Company
Cuban Restaurant 	Medical School 	Thread Supplier
Culinary School 	Medical Spa 	Threads and Yarns Wholesaler
Cultural Association 	Medical Supply Store 	Thrift Store
Cultural Center 	Medical Technology Manufacturer 	Tile Contractor
Cupcake Shop 	Medical Transcription Service 	Tile Manufacturer
Cured Ham Bar 	Medicine Exporter 	Tile Store
Cured Ham Store 	Meditation Center 	Time and Temperature Announcement Service
Cured Ham Warehouse 	Meditation Instructor 	Timeshare Agency
Curling Club 	Mediterranean Restaurant 	Tyre Manufacturer
Curling Hall 	Meeting Planning Service 	Tire Shop
Currency Exchange Service 	Mehandi Class 	Title Company
Curtain and Upholstery Cleaning Service 	Mehndi Designer 	Tobacco Exporter
Curtain Store 	Memorial Estate 	Tobacco Shop
Curtain Supplier and Maker 	Memorial Park 	Tobacco Supplier
Custom Confiscated Goods Store 	Mennonite Church 	Tofu Restaurant
Custom Home Builder 	Men’s Clothing Store 	Tofu Shop
Custom Label Printer 	Mens Tailor 	Toiletries Store
Custom T-shirt Store 	Mental Health Clinic 	Toll Road Rest Stop
Custom Tailor 	Mental Health Service 	Toll Booth
Customs Broker 	Mercantile Development 	Toner Cartridge Supplier
Customs Consultant 	Mercedes Benz Dealer 	Tongue Restaurant
Customs Department 	Messianic Synagogue 	Tonkatsu Restaurant
Customs Office 	Metal Construction Company 	Tool & Die Shop
Customs Warehouse 	Metal Detecting Equipment Supplier 	Tool Grinding Service
Cutlery Store 	Metal Fabricator 	Tool Manufacturer
Cycling Park 	Metal Finisher 	Tool Rental Service
Czech Restaurant 	Metal Heat Treating Service 	Tool Repair Shop
Dairy 	Metal Industry Suppliers 	Tool Store
Dairy Farm 	Metal Machinery Supplier 	Tool Wholesaler
Dairy Farm Equipment Supplier 	Metal Polishing Service 	Toolroom
Dairy Store 	Metal Processing Company 	Topography Company
Dairy Supplier 	Metal Stamping Service 	Topsoil Supplier
Dan Dan Noodle Restaurant 	Metal Supplier 	Tour Agency
Dance Club 	Metal Working Shop 	Tour Operator
Dance Company 	Metal Workshop 	Tourist Attraction
Dance Conservatory 	Metallurgy Company 	Tourist Information Center
Dance Hall 	Metalware Dealer 	Tower Communication Service
Dance Pavillion 	Metalware Producer 	Towing Equipment Provider
Dance Restaurant 	Metaphysical Supply Store 	Towing Service
Dance School 	Methodist Church 	Townhouse Complex
Dance Store 	Metropolitan Train Company 	Toy and Game Manufacturer
Danish Restaurant 	Mexican Goods Store 	Toy Library
Dart Bar 	Mexican Grocery Store 	Toy Manufacturer
Dart Supply Store 	Mexican Restaurant 	Toy Museum
Data Entry Service 	Mfr 	Toy Store
Data Recovery Service 	Microbiologist 	Toyota Dealer
Database Management Company 	Microwave Oven Repair Service 	Tractor Dealer
Dating Service 	Mid-Atlantic Restaurant (US) 	Tractor Equipment Supplier
Day Care Center 	Middle Eastern Restaurant 	Tractor Repair Shop
Day Spa 	Middle School 	Trade Fair Construction Company
Deaf Church 	Midwife 	Trade School
Deaf School 	Militar Archive 	Trading Card Store
Deaf Service 	Militar Residence 	Traditional Costume Club
Debris Removal Service 	Military Barracks 	Traditional Kostume Store
Debt Collecting 	Military Base 	Traditional Market
Debt Collection Agency 	Military Board 	Traditional Restaurant
Decal Supplier 	Military Cemetery 	Traditional Teahouse
Deck Builder 	Military Hospital 	Traditional American Restaurant
Deli 	Military Recruiting Office 	Traffic Officer
Delivery Chinese Restaurant 	Military School 	Traffic Police Station
Delivery Service 	Military Town 	Trailer Dealer
Demolition Contractor 	Milk Delivery Service 	Trailer Hitch Supplier
Jeans Shop 	Mill 	Trailer Manufacturer
Dental Clinic 	Millwork Shop 	Trailer Rental Service
Dental Hygienist 	Mine 	Trailer Repair Shop
Dental Implants Periodontist 	Mineral Water Company 	Trailer Supply Store
Dental Insurance Agency 	Mineral Water Wholesale 	Train Repairing Center
Dental Laboratory 	Miniature Golf Course 	Train Ticket Agency
Dental Radiology 	Miniatures Store 	Train Ticket Counter
Dental School 	Minibus Taxi Service 	Train yard
Dental Supply Store 	Mining Company 	Training Centre
Dentist 	Mining Consultant 	Training School
Denture Care Center 	Mining Engineer 	Transcription Service
Department for Regional Development 	Mining Equipment 	Translator
Department of Education 	Ministry of Education 	Transmission Shop
Department of Finance 	Mirror Shop 	Transportation Escort Service
Department of Housing 	Miso Cutlet Restaurant 	Transportation Service
Department of Motor Vehicles 	Missing Persons Organization 	Travel Agency
Department of Public Safety 	Mission 	Travel Clinic
Department of Social Services 	Mitsubishi Dealer 	Travellers Lodge
Department of Transportation 	Mobile Caterer 	Tree Farm
Department Store 	Mobile Disco 	Tree Service
Dept of City Treasure 	Mobile Hairdresser 	Trial Attorney
Dept of State Treasure 	Mobile Home Dealer 	Tribal Headquarters
Dermatologist 	Mobile Home Park 	Trinity Church
Desalination Plant 	Mobile Home Rental Agency 	Triumph Motorcycle Dealer
Design Agency 	Mobile Home Supply Store 	Trophy Shop
Design Engineer 	Mobile Money Agent 	Tropical Fish Store
Design Institute 	Mobile Network Operator 	Truck Accessories Store
Desktop Publishing Service 	Mobile Phone Repair Shop 	Truck Dealer
Sweets and Dessert Buffet 	Mobility Equipment Supplier 	Truck Farmer
Dessert Restaurant 	Model Car Play Area 	Truck Parts Supplier
Dessert Shop 	Model Design Company 	Truck Rental Agency
Detective 	Model Portfolio Studio 	Truck Repair Shop
Detention Center 	Model Train Store 	Truck Stop
Diabetes Center 	Modeling Agency 	Truck Topper Supplier
Diabetes Equipment Supplier 	Modeling School 	Truck Wash
Diabetologist 	Modern Art Museum 	Trucking Company
Diagnostic Center 	Modern British Restaurant 	Trucking School
Dialysis Center 	Modern European Restaurant 	Truss Manufacturer
Diamond Buyer 	Modern French Restaurant 	Trust Bank
Diamond Dealer 	Modular Home Builder 	Tsukigime Parking Lot
Diaper Service 	Modular Home Dealer 	Tune Up Supplier
Diesel Engine Dealer 	Mold Maker 	Tuning Automobile
Diesel Engine Repair Service 	Molding Supplier 	Tunisian Restaurant
Diesel Fuel Supplier 	Monastery 	Turf Supplier
Digital Printer 	Money Order Service 	Turkish Restaurant
Digital Printing Service 	Money Transfer Service 	Turkmen Restaurant
Dim Sum Restaurant 	Mongolian Barbecue Restaurant 	Turnery
Diner 	Monjayaki Restaurant 	Tuscan Restaurant
Dinner Theater 	Monogramming Service 	Tutoring Service
Direct Mail Advertising 	Montessori School 	Tuxedo Shop
Dirt Supplier 	Monument Maker 	Typewriter Repair Service
Disability Equipment Supplier 	Moped Dealer 	Typewriter Supplier
Disability Services & Support Organisation 	Moravian Church 	Typing Service
Disabled Sports Center 	Modern Izakaya Restaurants 	Udon Noodle Restaurant
Disc Golf Course 	Moroccan Restaurant 	Ukrainian Restaurant
Disciples of Christ Church 	Mortgage Broker 	Unagi Restaurant
Disco Club 	Mortgage Lender 	Underwear Store
Discount Store 	Mortuary 	Unemployment Insurance Consultant
Discount Supermarket 	Mosque 	Unemployment Office
Display Home Centre 	Motel 	Unfinished Furniture Store
Display Stand Manufacturer 	Motor Scooter Dealer 	Uniform Store
Disposable Tableware Supplier 	Motor Scooter Repair Shop 	Hairdresser
Distance Learning Center 	Motor Vehicle Dealer 	Unitarian Universalist Church
Distillery 	Motorcycle Dealer 	United Church of Canada
Distribution Service 	Motorcycle Driving School 	United Church of Christ
District Attorney 	Motorcycle Insurance Agency 	United Methodist Church
District Council 	Motorcycle Parts Store 	United States Armed Forces Base
District Government Office 	Motorcycle Rental Agency 	Unity Church
District Justice 	Motorcycle Repair Shop 	University
District Office 	Motorcycle Shop 	University Department
Dive Club 	Motoring Club 	University Hospital
Dive Shop 	Motorsports Store 	University Library
Diving Center 	Mountain Cable Car 	Upholstery Cleaning Service
Diving Contractor 	Mountain Cabin 	Upholstery Shop
Divorce Lawyer 	Mountaineering Class 	Urban Planning Department
Divorce Service 	Movie Rental Kiosk 	Urgent care center
DJ Service 	Movie Rental Store 	Urologist
DJ Supply Store 	Movie Studio 	Urology Clinic
Do-it-Yourself Shop 	Movie Theater 	Uruguayan Restaurant
Dock Builder 	Moving and Storage Service 	Pacific Northwest Restaurant (US)
Doctor 	Moving Company 	Used Appliance Store
Dodge Dealer 	Moving Supply Store 	Used Auto Parts Store
Dog Breeder 	MRI Center 	Used Bicycle Shop
Dog Cafe 	Muay Thai Boxing Gym 	Used Book Store
Dog Day Care Center 	Muffler Shop 	Used Car Dealer
Dog Hostel 	Mulch Supplier 	Used CD Store
Dog Park 	Multimedia and Electronic Book Publisher 	Used Clothing Store
Dog Sitter 	Municipal Administration Office 	Used Computer Store
Dog Trainer 	Municipal Corporation 	Used Furniture Store
Dog Walker 	Municipal Department Agricultural Development 	Used Game Store
Dogsled Ride Service 	Municipal Department Agriculture Food Supply 	Used Motorcycle Dealer
Dojo Restaurant 	Municipal Department Civil Defense 	Used Musical Instrument Store
Doll Restoration Service 	Municipal Department Communication 	Used Office Furniture Store
Doll Store 	Municipal Department Finance 	Used Store Fixture Supplier
Dollar Store 	Municipal Department Housing and Urban Development 	Used Tire Shop
Domestic Abuse Treatment Center 	Municipal Department of Culture 	Used Truck Dealer
Domestic Airport 	Municipal Department of Sports 	Utility Contractor
Dominican Restaurant 	Municipal Department of Tourism 	Utility Trailer Dealer
Donations Center 	Municipal Department Science Technology 	Uzbeki Restaurant
Donut Shop 	Municipal Department Social Defense 	Holiday Apartment
Door Manufacturer 	Municipal Guard 	Vacation Home Rental Agency
Door Shop 	Municipal Health Department 	Vacuum Cleaner Repair Shop
Door Supplier 	Municipal Office Education 	Vacuum Cleaner Store
Door Warehouse 	Municipal Social Development 	Vacuum Cleaning System Supplier
Double Glazing Installer 	Museum 	Valencian Restaurant
Down Home Cooking Restaurant 	Museum of Space History 	Valet Parking Service
Drafting Equipment Supplier 	Museum of Zoology 	Van Rental Agency
Drafting Service 	Music Box Store 	Vaporizer Store
Drainage Service 	Music College 	Variety Store
Drama School 	Music Conservatory 	Vascular Surgeon
Drama Theater 	Music Instructor 	Vastu Consultant
Drawing Lessons 	Music Management and Promotion 	VCR Repair Service
Dress and Tuxedo Rental Service 	Music Producer 	Vegan Restaurant
Dress Store 	Music Publisher 	Vegetable Wholesale Market
Dressmaker 	Music School 	Vegetable Wholesaler
Dried Flower Shop 	Music Store 	Vegetarian Cafe and Deli
Dried Seafood Store 	Musical Club 	Vegetarian Restaurant
Drilling Contractor 	Musical Instrument Manufacturer 	Vehicle Examination Office
Drilling Equipment Supplier 	Musical Instrument Rental Service 	Vehicle Exporter
Drinking Water Fountain 	Musical Instrument Repair Shop 	Vehicle Inspection
Drive-in Movie Theater 	Musical Instrument Store 	Vehicle Shipping Agent
Driver and Vehicle Licensing Agency 	Musician 	Velodrome
Driver’s License Office 	Musician and Composer 	Vending Machine Supplier
Drivers License Training School 	Mutton Barbecue Restaurant 	Venereologist
Driveshaft Shop 	Nail Salon 	Venetian Restaurant
Driving School 	Nanny 	Venezuelan Restaurant
Driving Test Centre 	Nanotechnology Engineer 	Ventilating Equipment Manufacturer
Drug Addiction Treatment Center 	National Forest 	Venture Capital Company
Drug Testing Service 	National Health Foundation 	Veterans Affairs Department
Drug Store 	National Library 	Veterans Center
Drum School 	National Museum 	Veterans Hospital
Drum Store 	National Park 	Veterans Organization
Dry Cleaner 	National Reserve 	Veterinarian
Dry Fruit Store 	Native American Goods Store 	Veterinary Pharmacy
Dry Ice Supplier 	Native American Restaurant 	Video Arcade
Dry Wall Contractor 	Natural Foods Store 	Video Camera Repair Service
Dry Wall Supply Store 	Natural Gas Supplier 	Video Conferencing Equipment Supplier
Ducati Dealer 	Natural History Museum 	Video Conferencing Service
Dude Ranch 	Natural Stone Exporter 	Video Duplication Service
Dump Truck Dealer 	Natural Stone Supplier 	Video Editing Service
Dump Truck Service 	Natural Stone Wholesaler 	Video Equipment Repair Service
Dumpling Restaurant 	Nature Preserve 	Video Game Rental Kiosk
Dutch Restaurant 	Naturopathic Practitioner 	Video Game Rental Service
Duty Free Store 	Naval Base 	Video Game Rental Store
DVD Store 	Navarraise Restaurant 	Video Game Store
Dye Store 	Neapolitan Restaurant 	Video Karaoke
Dyeworks 	Needlework Shop 	Video Production Service
Dynamometer Supplier 	Neon Sign Shop 	Video Store
E Commerce Agency 	Neonatal Physician 	Vietnamese Restaurant
E-commerce Service 	Nepalese Restaurant 	Villa
Ear Piercing Service 	Nephrologist 	Village Hall
Earth Works Company 	Netball Club 	Vineyard
East African Restaurant 	Neurologist 	Vineyard Church
Eastern European Restaurant 	Neurosurgeon 	Vintage Clothing Store
Eastern Orthodox Church 	New Age Church 	Violin Shop
Eating Disorder Treatment Center 	New England Restaurant 	Virtual Office Rental
Eclectic Restaurant 	New American Restaurant 	Visa and Passport Office
Ecological Park 	New Years Tree Market 	Visa Consultant
Ecologists Association 	New Zealand Restaurant 	Visitor Center
Economic Consultant 	News Service 	Vitamin & Supplements Store
Economic Development Agency 	Newspaper Advertising Department 	Vocal Instructor
Ecuadorian Restaurant 	Newspaper Distribution 	Vocational College
Education Center 	Newspaper Publisher 	Vocational School One
Educational Consultant 	Newsstand 	Vocational School
Educational Institution 	Nicaraguan Restaurant 	Volkswagen Dealer
Educational Supply Store 	Night Club 	Volleyball Club
Educational Testing Service 	Night Market 	Volleyball Court
Eftpos Equipment Supplier 	Nissan Dealer 	Volleyball Instructor
Egg Supplier 	Non-Denominational Church 	Volunteer Organization
Egyptian Restaurant 	Non-Governmental Organization 	Volvo Dealer
Elder Law Attorney 	Non-Profit Organization 	Voter Registration Office
Electric Motor Repair Shop 	Non Smoking Holiday Home 	Voting Facility
Electric Motor Store 	Noodle Shop 	Waldorf Kindergarten
Electric Utility Company 	North African Restaurant 	Waldorf School
Electric Utility Manufacturer 	Northern Italian Restaurant 	Walk-In Clinic
Electric Vehicle Charging Station 	Norwegian Restaurant 	Wallpaper Store
Electrical Appliance Wholesaler 	Notaries Association 	War Museum
Electrical Engineer 	Notary Public 	Warehouse
Electrical Equipment Supplier 	Notions Store 	Warehouse club
Electrical Installation Service 	Novelties Wholesaler 	Warehouse store
Electrical Repair Shop 	Novelty Store 	Washer & Dryer Repair Service
Electrical Substation 	Nuclear Engineer 	Washer & Dryer Store
Electrical Supply Store 	Nuclear Power Company 	Waste Management Service
Electrical Wholesaler 	Nuclear Power Plant 	Watch Manufacturer
Electrician 	Nudist Club 	Watch Repair Service
Electrolysis Hair Removal Service 	Nudist Park 	Watch Store
Electronic Engineer 	Nuevo Latino Restaurant 	Water Cooler Supplier
Electronic Parts Supplier 	Numerologist 	Water Damage Restoration Service
Electronics Accessories Wholesaler 	Convent 	Water Filter Supplier
Electronics Company 	Nursery School 	Water Jet Cutting Service
Electronics Engineer 	Nursing Agency 	Water Mill
Electronics Exporter 	Nursing Association 	Water Park
Electronics Hire Shop 	Nursing Home 	Water Polo Pool
Electronics Manufacturer 	Nursing School 	Water Pump Supplier
Electronics Repair Shop 	Nut Store 	Water Purification Company
Electronics Store 	Nutritionist 	Water Ski Shop
Electronics Vending Machine 	Nyonya Restaurant 	Water Skiing Club
Electronics Wholesaler 	Obanzai Restaurant 	Water Skiing Instructor
Elementary School 	Observation Deck 	Water Skiing Service
Elevator Manufacturer 	Observatory 	Water Softening Equipment Supplier
Elevator Service 	Women’s Health Clinic 	Water Sports Equipment Rental Service
Embassy 	Occupational Health Service 	Water Tank Cleaning Service
Embossing Service 	Occupational Medical Physician 	Water Testing Service
Embroidery Service 	Occupational Safety and Health 	Water Treatment Plant
Embroidery Shop 	Occupational Therapist 	Water Treatment Supplier
Emergency Call Booth 	Oden Restaurant 	Water Utility Company
Emergency Care Physician 	Off-road Race Track 	Water Works
Emergency Care Service 	Off Roading Area 	Water Works Equipment Supplier
Emergency Dental Service 	Off Track Betting Shop 	Waterbed Repair Service
Emergency Locksmith Service 	Offal Pot Cooking Restaurant 	Waterbed Store
Emergency Management Ministry 	Office Accessories Wholesaler 	Waterproofing Company
Emergency Room 	Office Equipment Rental Service 	Wax Museum
Emergency Training 	Office Equipment Repair Service 	Wax Supplier
Emergency Training School 	Office Equipment Supplier 	Waxing Hair Removal Service
Emergency Veterinarian Service 	Office Furniture Store 	Weather Forecast Service
Employment Agency 	Office of Vital Records 	Weaving Mill
Employment Attorney 	Office Refurbishment Service 	Web Hosting Company
Employment Center 	Office Space Rental Agency 	Website Designer
Employment Consultant 	Office Supply Store 	Wedding Bakery
Employment Search Service 	Office Supply Wholesaler 	Wedding Buffet
Endocrinologist 	Oil and Gas Exploration Service 	Wedding Chapel
Endodontist 	Oil Change Service 	Wedding Dress Rental Service
Endoscopist 	Oil & Natural Gas Company 	Wedding Photographer
Energy Equipment and Solutions 	Oil Field Equipment Supplier 	Wedding Planner
Energy Supplier 	Oil Refinery 	Wedding Service
Engine Rebuilding Service 	Oil Store 	Wedding Souvenir Shop
Engineer 	Oil Wholesaler 	Wedding Store
Engineering Consultant 	Oilfield 	Wedding Venue
Engineering School 	Okonomiyaki Restaurant 	Weigh Station
English Language Camp 	Oldsmobile Dealer 	Weight Loss Service
English Language Instructor 	Olive Oil Bottling Company 	Weightlifting Area
English Language School 	Olive Oil Cooperative 	Weir
English Restaurant 	Olive Oil Manufacturer 	Welder
Engraver 	Oncologist 	Welding Gas Supplier
Entertainer 	Opel dealer 	Welding Supply Store
Entertainment Agency 	Open Air Museum 	Well Drilling Contractor
Envelope Supplier 	Open University 	Wellness Center
Environment Office 	Opera Company 	Wellness Hotel
Environment Renewable Natural Resources 	Opera House 	Wellness Program
Environmental Consultant 	Ophthalmologist 	Welsh Restaurant
Environmental Engineer 	Ophthalmology Clinic 	Wesleyan Church
Environmental Health Service 	Optical Products Manufacturer 	West African Restaurant
Environmental Organization 	Optical Wholesaler 	Western Apparel Store
Environmental Protection Organization 	Optician 	Western Restaurant
Episcopal Church 	Optometrist 	Whale Watching Tour Agency
Equestrian Club 	Oral Surgeon 	Wheel Alignment Service
Equestrian Facility 	Orchard 	Wheel Store
Equestrian Resort 	Orchestra 	Wheelchair Rental Service
Equestrian Store 	Orchid Farm 	Wheelchair Repair Service
Equipment Exporter 	Orchid Grower 	Wheelchair Store
Equipment Importer 	Organ Donation and Tissue Bank 	Wholesale Bakery
Equipment Rental Agency 	Organic Drug Store 	Wholesale Drugstore
Equipment Supplier 	Organic Farm 	Wholesale Florist
Eritrean Restaurant 	Organic Food Store 	Wholesale Food Store
Erotic Massage 	Organic Restaurant 	Wholesale Grocer
Escrow Service 	Organic Shop 	Wholesale Jeweler
Espresso Bar 	Oriental Art Museum 	Wholesale Market
Estate Appraiser 	Oriental Goods Store 	Wholesale Plant Nursery
Estate Liquidator 	Oriental Medicine Clinic 	Wholesaler
Estate Planning Attorney 	Oriental Medicine Store 	Wholesaler Household Appliances
Ethiopian Restaurant 	Oriental Rug Store 	Wi-Fi Spot
Ethnic Restaurant 	Orphan Asylum 	Wicker Store
Ethnographic Museum 	Orphanage 	Wig Shop
European Institution 	Orthodontist 	Wildlife and Safari Park
European Restaurant 	Orthodox Church 	Wildlife Park
Evangelical Church 	Orthodox Synagogue 	Wildlife Refuge
Evening Dress Rental Service 	Orthopedic Clinic 	Wildlife Rescue Service
Evening School 	Orthopedic Shoe Store 	Willow Basket Manufacturer
Event Management Company 	Orthopedic Surgeon 	Wind Farm
Event Planner 	Orthoptist 	Wind Turbine Builder
Event Technology Service 	Orthotics & Prosthetics Service 	Window Cleaning Service
Event Ticket Seller 	Osteopath 	Window Installation Service
Event Venue 	Otolaryngologist 	Window Supplier
Excavating Contractor 	Otolaryngology Clinic 	Window Tinting Service
Executive Search Firm 	Otolaryngology Hospital 	Window Treatment Store
Executive Suite Rental Agency 	Outboard Motor Store 	Windsurfing Store
Executor 	Outdoor Activity Organiser 	Wine Bar
Exhibit 	Outdoor Bath 	Wine Cellar
Exhibition and Trade Centre 	Outdoor Clothing and Equipment Shop 	Wine Club
Exhibition Planner 	Outdoor Equestrian Facility 	Wine Storage Facility
Exporter 	Outdoor Furniture Store 	Wine Store
Extended Stay Hotel 	Outdoor movie theater 	Wine Wholesaler and Importer
Eye Care Center 	Outdoor Sports Store 	Winemaking Supply Store
Fabric Product Manufacturer 	Outdoor Swimming Pool 	Winery
Fabric Store 	Outerwear Store 	Wing Chun School
Fabric Wholesaler 	Outlet Mall 	Wok Restaurant
Fabrication Engineer 	Outlet Store 	Women’s Clothing Store
Facial Spa 	Oxygen Cocktail Spot 	Womens College
Factory Equipment Supplier 	Oxygen Equipment Supplier 	Women’s Organization
Faculty of Arts 	Oyster Bar Restaurant 	Womens Personal Trainer
Faculty of Law 	Oyster Supplier 	Womens Protection Service
Faculty of Pharmacy 	Pachinko Parlor 	Women’s Shelter
Faculty of Psychology 	Pacific Rim Restaurant 	Wood and Laminate Flooring Supplier
Faculty of Science 	Packaging Company 	Wood Floor Installation Service
Faculty of Sports 	Packaging Machinery 	Wood Floor Refinishing Service
Fair Trade Organization 	Packaging Supply Store 	Wood Frame Supplier
Fairground 	Padel Club 	Wood Stove Shop
Falafel Restaurant 	Padel Court 	Wood Supplier
Family Counselor 	Pagoda 	Wood Working Class
Family Day Care Service 	Pain Control Clinic 	Woodworker
Family Hotel 	Pain Management Physician 	Woodworking Supply Store
Family Law Attorney 	Paint Manufacturer 	Wool Store
Family Planning Center 	Paint Store 	Work Clothes Store
Family Planning Counselor 	Paint Stripping Company 	Workers’ Club
Family Practice Physician 	Paintball Center 	Working Womens Hostel
Family Restaurant 	Paintball Store 	Wrestling School
Family Service Center 	Painter 	X-ray Equipment Supplier
Farm 	Painting 	X-ray Lab
Farm Bureau 	Painting Lessons 	Xiang Cuisine Restaurant
Farm Equipment Repair Service 	Painting Studio 	Yacht Broker
Farm Equipment Supplier 	Paintings Store 	Yacht Club
Farm Household Tour 	Pakistani Restaurant 	Yakatabune
Farm School 	Pallet Supplier 	Yakiniku Restaurant
Farm Shop 	Pan-Asian Restaurant 	Yakitori Restaurant
Farmers’ Market 	Pan-Latin Restaurant 	Yamaha Motorcycle Dealer
Farmstay 	Pancake Restaurant 	Yarn Store
Fashion Accessories Store 	Paper Bag Supplier 	Yemenite Restaurant
Fashion Design School 	Paper Distributor 	Yeshiva
Fashion Designer 	Paper Exporter 	Yoga Instructor
Fast Food Restaurant 	Paper Mill 	Yoga Retreat Center
Fastener Supplier 	Paper Shredding Machine Supplier 	Yoga Studio
Favela 	Paper Store 	Youth Care
Fax Service 	Paraguayan Restaurant 	Youth Center
Federal Agency for Technical Relief 	Paralegal Services Provider 	Youth Clothing Store
Federal Credit Union 	Parasailing Ride Service 	Youth Club
Federal Government Office 	Parish 	Youth Group
Federal Police 	Park 	Youth Hostel
Federal Reserve Bank 	Park & Ride 	Youth Organization
Feed Manufacturer 	Parking Garage 	Youth Social Services Organization
Animal Feed Store 	Parking Lot 	Zac
Felt Boots Store 	Parking Lot for Bicycles 	Zhe Jiang Restaurant
Fence Contractor 	Parking Lot for Motorcycles 	Zoo
Fence Supply Store 	Parkour Spot